################
#    E     E   #
# B#B# #B#B#B# #
#         U    #
# #B# # #B#B#  #
#    B P B     #
#  #B#B##B#B#B #
#              #
# B# #B#D# #B# #
#      E       #
################
