################
#              #
#              #
#        EU    #
#              #
#      P       #
#  #BDB# #B#B# #
#              #
# B# #B#B# #B# #
#      E       #
################
