################
#              #
#  B       P   #
#  B           #
#  B           #
#  BBBB        #
#      BBBBB   #
#      D       #
#  U   BBBBB   #
#              #
################
