################
# E   #   E    #
#B#B# #B#B#D#B #
#      U       #
# #B# # #B#B#  #
#     P   B#   #
# #B#B#B#B#B#B #
#       E      #
# B# #B#B# #B# #
#    E         #
################
