################
# E     # E    #
#B#B#B# #B#B#B #
#  U B#        #
# #B#B# #B#B#B #
#P B#B# #B#B#  #
# #B#B#D#B#B#B #
#   E       E  #
# B#B# #B#B#B# #
#          E   #
################
