################
# E   #        #
#B#B#B#B#B#B#B #
# BUD#   B#B#  #
# #B#B  #B#B#B #
# B#B#P#B#B#B# #
# #B#   #B#B#B #
#     E     E  #
# B#B# #B#B#B# #
# E       E  E #
################
