################
##            ##
#  B       P   #
#  B           #
#  B      E    #
#  BBBB        #
#      BBBBB   #
#      B       #
#  E   BBBBB   #
##            ##
################
