################
#      E       #
# B#B# #B#B#B# #
#         U    #
# #B# # #B#B#  #
#      P       #
#  #BDB# #B#B# #
#              #
# B# #B#B# #B# #
#      E       #
################
